#---#---#---#---#---#---#---#---#---#---#---#---#---#---#---#---#---#---#---#---#---#---#---#---#---# 
|       |       |   |               |   |                                                           |
#---#   #   #   #   #   #   #---#   #   #   #---#---#---#---#---#---#---#---#---#   #---#---#---#---# 
|   |       |   |       |   |       |                   |                       |   |               |
#   #---#---#   #---#---#   #   #---#---#   #---#---#   #---#---#   #---#---#   #   #   #---#---#   # 
|           |       |       |   |       |   |       |               |       |   |       |   |       |
#   #---#---#---#   #   #---#   #   #   #   #   #   #---#---#---#---#   #   #   #---#---#   #   #---# 
|           |       |   |   |   |   |   |   |   |       |               |   |           |   |       |
#   #---#   #   #---#   #   #   #   #   #---#   #---#   #   #---#---#---#   #---#---#   #   #---#   # 
|   |   |   |   |       |           |           |       |   |               |           |       |   |
#   #   #   #   #---#   #---#---#---#---#---#---#   #---#   #   #---#---#---#---#---#   #   #   #   # 
|   |   |   |       |       |                       |       |       |               |       |   |   |
#   #   #   #---#   #---#   #   #---#---#   #---#---#   #---#---#   #---#   #---#   #---#---#---#   # 
|       |       |       |   |   |       |   |       |       |   |           |   |                   |
#   #---#   #   #---#   #   #---#   #   #   #   #   #   #   #   #---#---#---#   #---#---#---#---#   # 
|   |       |   |   |   |           |   |       |   |   |   |   |                           |       |
#   #   #---#   #   #   #---#---#---#   #---#---#   #---#   #   #   #---#---#   #---#---#---#   #---# 
|   |   |       |   |                   |       |           |       |       |   |               |   |
#---#   #   #---#   #---#---#---#---#---#   #   #---#---#---#   #---#   #   #   #   #---#---#---#   # 
|       |           |               |       |           |       |       |       |       |   |       |
#   #   #---#---#   #---#   #   #---#   #   #---#---#   #   #---#   #---#---#   #---#   #   #   #   # 
|   |   |       |       |   |       |   |           |   |   |   |       |       |       |       |   |
#   #---#   #   #---#   #---#---#   #   #---#---#   #   #   #   #---#   #---#---#   #---#---#---#   # 
|           |       |           |   |           |   |   |   |       |           |               |   |
#   #---#---#---#   #---#---#   #   #---#---#   #   #   #   #   #---#---#---#   #---#---#---#   #   # 
|   |       |       |               |           |   |   |   |           |   |       |           |   |
#   #   #   #   #---#---#---#---#---#   #---#---#   #   #   #---#   #   #   #---#   #   #---#---#   # 
|   |   |   |                       |           |   |   |           |   |       |   |       |       |
#   #---#   #---#---#---#---#---#   #---#---#   #   #---#---#---#---#   #   #   #   #---#   #   #   # 
|                               |               |                           |   |               |   |
#---#---#---#---#---#---#---#---#---#---#---#---#---#---#---#---#---#---#---#---#---#---#---#---#---#
