#---#---#---#---#---#---#---#---#---#---#---#---#---#---#---#---#---#---#---#---#---#---#---#---#---# 
|       |       |                               |           |                           |           |
#---#   #   #   #   #---#---#---#---#---#---#   #   #---#   #---#   #---#   #---#---#   #   #   #---# 
|       |   |       |               |   |       |   |   |       |   |       |       |   |   |       |
#   #---#   #---#---#---#   #---#   #   #   #---#   #   #---#   #---#   #---#   #---#   #---#   #   # 
|   |       |           |   |   |       |       |   |   |       |       |   |       |       |   |   |
#   #---#   #   #---#   #   #   #---#   #---#   #   #   #   #---#   #---#   #   #   #---#   #---#   # 
|   |       |       |       |       |   |   |       |   |           |           |           |       |
#   #   #---#   #   #---#---#---#   #   #   #---#---#   #---#---#---#   #---#---#---#---#---#   #   # 
|       |       |   |               |   |       |               |   |           |               |   |
#---#---#---#---#   #   #   #---#---#   #   #---#   #   #---#   #   #---#---#   #---#   #---#---#   # 
|                   |   |   |       |   |   |       |       |               |   |       |       |   |
#---#   #---#---#---#   #---#   #   #   #   #   #---#---#   #---#---#---#   #   #   #---#   #   #   # 
|       |           |       |   |       |       |       |       |           |   |       |   |   |   |
#   #---#---#   #---#   #   #   #---#---#   #---#---#   #---#   #---#---#---#   #   #   #---#   #   # 
|           |   |       |       |               |       |       |               |   |       |   |   |
#---#---#   #   #   #---#---#---#---#---#---#   #   #---#   #---#   #---#---#---#---#---#   #   #   # 
|           |   |   |       |           |           |       |       |   |           |       |       |
#   #---#---#   #   #   #   #   #---#   #---#   #---#   #   #   #---#   #   #   #   #   #---#   #---# 
|           |           |   |       |       |   |       |   |   |           |   |       |       |   |
#   #---#   #   #---#---#   #---#   #---#   #   #   #---#   #   #   #---#---#   #---#---#   #---#   # 
|   |   |   |   |       |   |       |   |   |   |       |   |   |   |           |       |       |   |
#   #   #   #   #   #   #   #   #---#   #   #   #---#   #   #   #   #   #---#---#   #   #---#   #   # 
|       |   |   |   |   |       |           |   |       |   |   |   |           |   |           |   |
#   #---#   #---#   #   #---#---#---#---#   #---#   #---#---#   #---#---#   #   #   #---#---#---#   # 
|   |       |       |                   |           |           |       |   |   |       |       |   |
#---#   #---#   #---#---#---#---#---#   #   #---#---#   #---#---#   #   #---#   #---#   #   #   #   # 
|       |       |                   |   |   |           |           |           |       |   |       |
#   #---#   #---#---#---#   #---#   #   #---#   #---#---#---#   #---#---#---#---#   #---#   #---#   # 
|                           |       |                           |                           |       |
#---#---#---#---#---#---#---#---#---#---#---#---#---#---#---#---#---#---#---#---#---#---#---#---#---#
