#---#---#---#---#---#---#---#---#---#---#---#---#---#---#---#---#---#---#---#---#---#---#---#---#---# 
|           |                           |                                   |                       |
#---#---#   #---#   #---#---#---#---#   #---#---#   #   #   #---#---#---#   #   #---#   #---#---#---# 
|       |       |       |           |           |   |   |   |           |   |       |   |           |
#   #   #---#   #---#   #   #---#   #---#---#   #   #   #---#   #---#   #   #   #   #---#   #---#   # 
|   |       |   |       |   |   |   |           |   |   |       |       |   |   |               |   |
#   #---#---#   #   #---#   #   #   #   #---#---#   #   #   #---#   #---#   #   #---#---#---#---#   # 
|           |       |           |   |   |       |   |           |   |       |       |       |       |
#   #---#   #---#---#   #---#---#   #   #   #   #---#---#---#---#   #   #---#---#---#   #   #   #   # 
|   |   |   |       |   |   |       |       |   |                   |                   |       |   |
#   #   #   #   #   #   #   #   #---#---#---#   #   #---#---#---#---#---#---#---#---#---#---#---#   # 
|   |   |       |   |   |   |   |           |       |                   |       |                   |
#   #   #---#---#   #   #   #   #   #---#   #---#---#   #   #---#---#   #---#   #   #---#---#---#---# 
|   |           |       |   |       |   |       |       |   |                   |                   |
#   #   #---#   #---#---#   #---#---#   #---#   #   #---#   #---#---#---#---#---#---#---#---#---#   # 
|   |       |       |                   |       |       |   |           |               |       |   |
#   #---#---#   #   #---#---#---#---#   #   #   #   #---#   #   #---#   #   #---#---#   #   #   #   # 
|           |   |                   |   |   |   |   |       |   |   |       |           |   |       |
#---#---#   #   #---#   #---#---#   #   #   #---#   #   #   #   #   #---#---#   #---#   #   #---#---# 
|   |       |   |       |       |       |           |   |   |           |       |       |   |       |
#   #   #---#   #---#---#   #   #---#---#---#---#---#   #   #---#   #---#   #   #---#---#   #   #   # 
|   |   |       |       |   |           |           |   |       |   |       |   |       |   |   |   |
#   #   #   #   #   #   #   #---#---#   #   #---#   #   #---#---#   #   #---#---#   #   #   #   #---# 
|       |   |       |   |   |       |   |       |       |           |   |       |   |       |       |
#   #---#---#---#---#   #   #---#   #   #---#   #---#   #   #---#---#   #   #   #   #---#---#---#   # 
|               |       |       |               |       |       |       |   |       |           |   |
#---#---#---#   #   #   #---#   #---#---#   #---#---#---#---#   #   #---#   #---#---#   #   #   #   # 
|   |           |   |   |       |       |   |               |   |       |   |           |   |       |
#   #   #---#---#   #   #   #---#   #   #---#   #---#---#   #   #---#   #   #---#---#---#   #---#   # 
|                   |   |           |                   |           |                       |       |
#---#---#---#---#---#---#---#---#---#---#---#---#---#---#---#---#---#---#---#---#---#---#---#---#---#
