#---#---#---#---#---#---#---#---#---#---#---#---#---#---#---#---#---#---#---#---#---#---#---#---#---# 
|   |                           |       |               |               |                           |
#   #---#---#---#---#   #---#   #---#   #   #---#---#   #   #   #---#   #---#---#   #---#---#---#   # 
|                   |       |       |       |       |       |       |           |           |   |   |
#---#---#---#---#   #---#   #---#   #---#   #   #---#---#---#---#   #---#---#   #---#---#   #   #   # 
|                   |       |   |       |       |                   |                       |       |
#   #---#---#---#---#   #---#   #---#   #---#   #   #---#---#---#   #---#---#---#   #---#---#   #---# 
|           |       |       |       |       |   |       |   |       |           |   |       |   |   |
#---#---#   #   #   #   #   #   #   #---#   #   #---#   #   #   #---#   #---#   #---#   #   #   #   # 
|       |   |   |       |   |   |       |   |   |   |   |           |       |           |   |       |
#   #   #   #---#---#   #   #   #---#   #   #   #   #   #---#---#---#---#   #---#---#---#   #---#   # 
|   |   |           |   |   |   |   |       |   |   |   |               |   |           |   |       |
#   #   #---#---#   #---#   #   #   #---#---#   #   #   #   #---#---#   #   #---#---#   #   #---#   # 
|   |       |   |   |       |   |       |   |   |   |   |           |   |           |   |       |   |
#   #---#   #   #   #   #---#   #   #   #   #   #   #   #---#---#   #   #---#---#   #   #---#   #---# 
|   |   |   |   |       |       |   |   |           |           |   |       |       |       |       |
#   #   #   #   #---#---#   #---#   #   #---#---#   #---#---#   #   #   #---#   #---#   #---#---#   # 
|   |               |       |       |       |       |       |       |   |       |       |           |
#   #---#   #---#---#   #---#   #---#---#   #   #---#---#   #---#---#   #   #---#---#   #   #---#   # 
|       |   |       |           |       |   |       |       |       |       |           |       |   |
#---#   #---#   #   #---#---#---#   #---#   #---#   #   #   #   #   #---#---#   #---#   #---#   #---# 
|       |       |           |           |       |       |       |       |       |       |   |       |
#   #---#   #---#   #---#---#   #---#   #---#   #---#---#---#---#---#   #   #---#   #---#   #---#   # 
|       |       |       |       |   |       |       |           |       |       |   |       |       |
#   #   #---#   #---#   #   #---#   #---#   #---#   #   #---#   #   #---#---#   #   #   #   #   #   # 
|   |       |       |       |           |       |       |   |   |               |   |   |   |   |   |
#   #---#   #---#   #---#---#   #---#   #---#   #---#---#   #   #   #---#---#---#   #---#   #   #   # 
|   |   |       |       |       |       |   |   |           |   |   |           |           |   |   |
#   #   #---#   #---#   #   #---#   #---#   #   #   #---#   #   #---#   #---#   #---#---#---#   #   # 
|           |               |               |           |               |                       |   |
#---#---#---#---#---#---#---#---#---#---#---#---#---#---#---#---#---#---#---#---#---#---#---#---#---#
