#---#---#---#---#---#---#---#---#---#---#---#---#---#---#---#---#---#---#---#---#---#---#---#---#---# 
|               |                   |       |       |           |           |           |           |
#---#---#---#   #   #---#   #   #---#   #   #   #   #   #---#   #   #---#   #   #   #   #---#   #   # 
|           |   |       |   |   |       |       |       |   |       |   |       |   |           |   |
#   #---#   #   #---#---#   #---#   #---#---#---#---#---#   #---#---#   #---#---#   #---#---#---#   # 
|   |       |           |                       |               |           |       |           |   |
#   #   #   #---#---#   #---#---#---#---#---#   #   #---#---#   #   #   #---#   #---#---#---#   #   # 
|   |   |           |           |       |       |           |   |   |   |       |               |   |
#   #   #---#---#---#---#---#   #   #   #   #---#   #---#   #   #---#   #   #---#---#   #---#---#   # 
|   |   |                   |       |   |       |       |   |   |       |           |               |
#---#   #   #---#---#   #---#---#---#   #---#   #---#---#   #   #   #---#---#   #   #   #---#---#---# 
|       |   |       |   |               |                   |       |       |   |   |   |           |
#   #---#   #   #---#   #   #---#---#---#---#---#---#---#---#---#   #   #   #---#   #   #   #---#   # 
|   |       |   |       |       |                   |               |   |           |       |       |
#   #   #---#   #   #---#---#   #---#---#   #---#   #   #---#---#---#   #   #---#---#---#---#---#   # 
|   |           |               |           |       |       |   |       |   |       |           |   |
#   #---#---#   #---#---#---#---#   #---#---#   #---#---#   #   #   #---#---#   #   #   #---#   #   # 
|           |           |                   |   |       |       |               |   |   |       |   |
#---#   #   #---#---#   #---#---#---#   #   #   #---#   #---#   #---#---#---#---#   #   #   #---#   # 
|       |           |               |   |   |       |       |       |           |       |   |       |
#   #---#---#---#---#---#---#---#   #   #   #---#   #   #---#---#   #---#   #---#---#---#   #   #---# 
|                       |           |   |   |       |   |       |       |               |   |       |
#   #---#---#---#---#   #   #---#---#   #   #   #---#   #   #   #---#   #   #---#   #   #   #---#---# 
|           |       |   |   |           |   |   |           |   |       |       |   |   |           |
#---#---#   #   #   #   #   #---#---#---#   #   #---#   #---#   #   #---#---#---#   #   #---#---#   # 
|       |   |   |       |       |           |       |       |       |               |   |           |
#   #---#   #   #---#---#---#   #   #---#---#---#   #---#   #---#---#   #---#---#---#   #   #---#   # 
|   |       |   |       |       |       |       |       |               |       |       |       |   |
#   #   #---#   #   #   #   #---#---#   #   #   #---#   #---#---#---#---#   #   #---#---#---#   #   # 
|           |       |                   |   |                               |                   |   |
#---#---#---#---#---#---#---#---#---#---#---#---#---#---#---#---#---#---#---#---#---#---#---#---#---#
