#---#---#---#---#---#---#---#---#---#---#---#---#---#---#---#---#---#---#---#---#---#---#---#---#---# 
|   |       |       |                           |                           |       |               |
#   #   #   #---#   #   #---#   #   #---#---#   #   #---#---#---#---#---#   #   #---#   #   #---#---# 
|   |   |       |           |   |   |       |       |       |       |       |       |   |           |
#   #   #---#   #---#---#   #   #---#   #   #---#---#   #   #---#   #   #---#---#   #   #---#---#   # 
|       |   |       |       |           |   |           |       |   |   |           |   |       |   |
#---#---#   #---#   #---#---#---#---#   #   #---#   #---#---#   #   #   #   #   #---#   #   #   #   # 
|               |                   |   |   |       |               |   |   |   |       |   |       |
#   #---#---#   #---#---#---#---#   #   #   #   #---#---#---#---#---#   #   #   #   #---#   #---#   # 
|       |           |       |       |   |   |               |       |   |   |       |       |       |
#---#   #   #---#   #   #   #   #---#---#   #---#   #---#   #   #   #   #---#---#---#   #---#   #---# 
|       |   |           |   |   |       |       |   |   |       |   |   |               |           |
#   #---#   #---#---#---#---#   #   #   #   #   #   #   #---#---#   #   #   #---#---#   #---#---#---# 
|   |   |       |           |   |   |   |   |   |   |           |       |           |   |           |
#   #   #---#   #   #---#   #   #   #   #---#   #   #   #   #---#---#---#---#---#   #   #   #---#   # 
|       |   |   |   |       |   |   |   |       |   |   |                           |   |       |   |
#---#   #   #   #   #   #---#   #   #   #   #---#   #   #---#   #---#---#---#---#---#---#---#   #   # 
|   |       |       |       |       |       |   |   |       |           |                       |   |
#   #---#   #---#---#---#   #---#---#---#---#   #   #---#---#---#   #   #   #---#---#---#---#   #   # 
|       |   |       |                   |       |   |           |   |       |               |   |   |
#   #---#   #   #   #   #   #---#---#---#   #   #   #   #---#   #---#   #---#   #---#---#   #---#   # 
|   |       |   |   |   |   |           |   |   |   |       |       |   |       |       |           |
#   #   #---#   #   #   #---#   #---#   #   #   #   #   #   #---#   #   #   #---#   #   #---#---#   # 
|   |   |       |   |           |   |       |       |   |   |   |   |   |   |       |           |   |
#   #   #   #---#   #---#---#---#   #---#---#---#---#---#   #   #   #   #   #   #---#   #---#   #   # 
|   |       |   |           |       |                       |       |   |   |       |   |       |   |
#   #---#---#   #---#---#   #   #   #   #---#---#---#---#---#   #---#   #   #---#---#   #   #---#   # 
|       |       |       |   |   |   |       |   |               |       |       |       |   |       |
#   #   #   #   #   #   #   #   #   #---#   #   #   #---#---#---#---#---#---#   #   #---#---#   #---# 
|   |       |       |           |           |                                   |                   |
#---#---#---#---#---#---#---#---#---#---#---#---#---#---#---#---#---#---#---#---#---#---#---#---#---#
