#---#---#---#---#---#---#---#---#---#---#---#---#---#---#---#---#---#---#---#---#---#---#---#---#---# 
|   |               |               |                                   |   |                       |
#   #---#---#   #   #   #   #---#   #   #---#---#   #---#---#---#---#   #   #   #   #---#---#---#---# 
|   |           |   |   |   |   |   |   |       |           |       |   |   |   |   |               |
#   #   #---#---#   #---#   #   #   #   #---#   #---#---#   #   #---#   #   #   #   #   #---#---#   # 
|       |       |   |       |       |               |       |           |   |   |       |       |   |
#---#---#   #   #   #   #---#   #---#---#---#   #---#   #---#---#---#   #   #   #---#---#   #   #   # 
|           |   |       |       |               |       |           |       |       |       |   |   |
#   #---#---#   #---#---#   #---#   #---#---#---#   #---#   #---#   #---#   #---#   #---#---#   #   # 
|           |   |       |       |               |           |   |       |       |       |       |   |
#---#---#---#   #   #   #---#   #---#---#---#---#   #---#---#   #---#   #---#---#---#   #   #   #   # 
|           |       |       |   |               |                   |   |       |           |   |   |
#   #---#   #---#---#   #   #   #   #---#---#   #---#---#---#---#   #   #   #   #   #---#---#---#   # 
|   |   |               |   |       |       |       |           |   |       |   |       |           |
#   #   #---#---#---#---#   #---#---#   #   #---#   #   #---#   #   #---#---#   #---#   #   #---#---# 
|   |                   |   |           |   |       |       |   |       |   |           |           |
#   #   #---#---#---#---#   #   #   #---#   #   #---#---#   #   #---#   #   #---#---#---#---#---#   # 
|   |           |           |   |   |       |       |       |       |   |       |           |       |
#   #   #---#   #   #---#---#   #   #---#   #---#   #   #---#---#   #   #   #   #---#   #---#   #   # 
|   |       |               |   |       |   |       |       |       |       |           |       |   |
#   #---#---#---#---#---#   #---#---#   #---#   #---#   #---#   #   #---#   #---#---#---#   #---#---# 
|       |               |               |       |       |       |   |       |           |   |       |
#   #   #   #---#---#   #---#---#---#   #   #---#   #---#   #   #---#   #---#   #---#   #   #   #   # 
|   |   |       |   |       |           |   |       |   |   |   |           |   |       |       |   |
#---#   #---#   #   #---#   #---#---#   #   #   #---#   #   #---#   #---#---#   #   #---#---#   #   # 
|       |       |   |       |       |   |   |           |           |           |   |       |   |   |
#   #---#   #---#   #   #---#   #   #---#   #---#---#---#---#   #---#   #---#---#   #   #   #---#   # 
|       |   |       |   |       |       |           |       |   |       |   |       |   |   |       |
#   #   #   #---#   #   #   #---#---#   #---#---#   #   #   #---#   #---#   #   #---#   #   #   #   # 
|   |               |               |                   |           |                   |       |   |
#---#---#---#---#---#---#---#---#---#---#---#---#---#---#---#---#---#---#---#---#---#---#---#---#---#
